# # # # # # # # # # # # # #
# 0 0 0 0 0 0 0 T 0 0 0 # #
# 0 0 0 T 0 0 0 S 0 B 0 # #
# 0 B 0 T B W 0 B T 0 0 # #
# S 0 0 S S W 0 B T 0 S # #
# S 0 0 T B W 0 B T 0 S # #
# S 0 0 T B 0 0 B T B W # #
# S 0 0 0 0 0 W 0 T 0 S # #
# S 0 0 T B W 0 0 0 0 S # #
# 0 0 0 T T W W T T 0 0 # #
# 0 0 0 T T 0 0 S 0 0 0 # #
# 0 B 0 0 0 0 T T T B 0 # #
# W W F 0 S 0 W S 0 0 0 # #
# # # # # # # # # # # # # #